wwwwwwwwwwwwwwwwwwwwwww
w.....................w
w.....................w
w.....................w
w.....................w
wm....................w
wm.m.m................w
wm.m.m.m.m............w
wm.m.m.m.m.m.m........w
wm.m.m.m.m.m.m.m.m....w
wb.b.b.b.b.b.b.b.b....w
w.....................w
w.....................w
w.....................w
w.....................w
w.....................w
w.....................w
w.....................w
w.....................w
w.....................w
w.....................w
w.....................w
w....A........B.......w
w.....................w