wwwwwwwwwwwwwwwwwwwwwww
w.....................w
w.....................w
wnm.m.m.m.m.m.m.m.m.m.w
wm.m.m.m.m.m.m.m.m.m.nw
wnm.m.m.m.m.m.m.m.m.m.w
wm.m.m.m.m.m.m.m.m.m.nw
wnm.m.m.m.m.m.m.m.m.m.w
w.....................w
w.....................w
w.....................w
w.....................w
w.....................w
w.....................w
w.....................w
w.....................w
w.....................w
w.....................w
w....A........B.......w
w.....................w