wwwwwwwwwwwwwwwwwwwwwwwwwwww
w.........A.....B..........w
w..........................w
w..........................w
w..........................w
wwwwwwwwwwwww.wwwwwwwwwwwwww
w.......................w00w
w....1..1..1..1........w...w
w..........................w
w.1..1..1..1.........w.00..w
w...................w..00..w
wwwwwwwwwwwwwwwwwwwwwwwwwwww