wwwwwwwwwwwwwwwwwww
w1................w
w.................w
w.................w
w.................w
w.B............A.cw
w.................w
w.................w
w.................w
wr................w
wwwwwwwwwwwwwwwwwww