wwwwwwwwwwwwwwww
w..............w
w..........b...w
w.........b....w
w........b..2..w
w.B.........A.cw
w.f......b.....w
w.........b....w
w..........b...w
w..............w
wwwwwwwwwwwwwwww