wwwwwwwwwwwwwwww
w..............w
w.......b......w
w.......bb.....w
w.B.....bb..A.cw
w.......bb.....w
w.......b......w
w..............w
wwwwwwwwwwwwwwww