wwwwwwwwwwwwwwwwwww
w........n........w
w0w.............w4w
w.....1.....5.....w
w...A....+....B...w
w.....1.....5.....w
w0w.............w4w
w.................w
wwwwwwwwwwwwwwwwwww