wwwwwwwwwwwwwwwwwwwwwww
w.....................w
w0...................4w
w1.........n.........5w
w...A.....n+n.....B...w
w2.........n.........6w
w3...................7w
w.....................w
wwwwwwwwwwwwwwwwwwwwwww