wwwwwwwwwwwwwwwwwww
w.................w
w.0...0.....4...4.w
w.................w
w...A.+.....+.B...w
w.................w
w.0...0.....4...4.w
w.................w
wwwwwwwwwwwwwwwwwww