wwwwwwwwwwwwwwwwwwwwwwwww
w-t...................w+w
w-.....................+w
w-.....................+w
w-.....................+w
w-.B..................A+w
w-...............s.....+w
w-.....................+w
w-.....................+w
w-.....................+w
w-.....................+w
w-w...................s+w
wwwwwwwwwwwwwwwwwwwwwwwww