wwwwwwwwwwwwwwwwwwwwww
w+w................w-w
w+..................-w
w+..................-w
w+..................-w
w+wA..............Bw-w
w+....o........o....-w
w+w................w-w
w+..................-w
w+..................-w
w+..................-w
w+w................w-w
wwwwwwwwwwwwwwwwwwwwww