wwwwwwwwwwwwwwwwwwwwww
w+..................-w
w+..................-w
w+..................-w
w+..................-w
w+A................B-w
w+.........o........-w
w+..................-w
w+..................-w
w+..................-w
w+..................-w
w+..................-w
wwwwwwwwwwwwwwwwwwwwww