wwwwwwwwwwwwwwwwwww
w...t.........t...w
w...t.........b...w
w...b....e....t...w
w...wtttttttttw...w
w...w.........w...w
wbbbw....A....wtttw
w...wttbttttttw...w
w...t.........b...w
w...b.........t...w
w...t.........t...w
wwwwwwwwwwwwwwwwwww