wwwwwwwwwwwwwwwwwww
w.........t.......w
wttbtwwwwwwwwtttbtw
w.....t...t.......w
w.....b.A.te......w
w.....t...t.......w
wttbtwwwwwwwwtbtttw
w.........b.......w
wwwwwwwwwwwwwwwwwww