wwwwwwwwww
w........w
w...A....w
w........w
w........w
w........w
w.....p..w
w....sss.w
w........w
wwwwwwwwww