wwwwwwwwwwwwwwwwwwww
w.A........ws......w
w..........w.......w
w..........wwwwwwp.w
w..................w
wwwwwww....w.pwwwwww
w.....w....w.......w
w..........w.......w
w.s...p....w....s..w
wwwwwwwwwwwwwwwwwwww