wwwwwwwwwwww
w..........w
w...ww.....w
w.t........w
w.t........e
w.t.......ww
w...w......w
w....w....uw
t........lAt
tttttttttttt