wwwwwwwwwww
w.w.......w
w.....w...w
tu........w
tAr......ww
td........w
t...w.....e
t....w....w
t.........w
t.......w.w
ww........w
w......w..w
wwwwwwwwwww