wwwwwwwwwwwwwwwwwwwwwww
w.....................w
w..dppppppppppppppppp3w
w...p...h...v...h.t...w
w...p...v...A...v.p...w
w...p...h...v...h.p...w
w...pppppppppppppppu..w
w...r.................w
wwwwwwwwwwwwwwwwwwwwwww