wwwwwwwwwwwwwwwwwwwwwwww
w............hdppppppp3w
w.A............p.......w
w............v.p.v.h.v.w
w..............p.......w
w.....v......h.p.......w
w..............p.......w
w.....hdpppppppp.......w
w.......p......l.......w
w.....v.p.v.h.v..h.....w
w.......p..............w
w.....h.p..............w
w.......p..............w
w.......p..............w
w.......t..............w
wwwwwwwwwwwwwwwwwwwwwwww
