wwwwwwwwwwwwwwwwwwwwwww
w.......l..A..........w
wtppppppp..h.dppppppp3w
w.......p.....p.......w
w..h.v..p..v..p..v.h..w
w.......p.....p.......w
w.......p..v..p.......w
w......uppppppp.......w
w..........h..l.......w
w..h....v.....v....h..w
w.....................w
wwwwwwwwwwwwwwwwwwwwwww