wwwwwwwwwwwwwwwwwwww
w........dpppppppp3w
w.......h.p........w
w...A...v.p........w
w.........p....l...w
w..dpppppppppppp...w
w...p.....p....p...w
w.v.p.hvh.p....p...w
w...p.....p....p...w
w.h.p.....ppppppu..w
w...p.....r........w
w.v.p.......vhv....w
w...p..............w
wwwwt..............w
wwwwwwwwwwwwwwwwwwww