wwwwwwwwwwwwww
w...........ww
w..dpppppppp3w
w.v.p........w
w...p..v.h...w
w.h.p........w
w...ppppppd..w
w...r....p...w
w......h.p...w
w.A......p...w
w......v.p...w
w........p...w
w...tppppp...w
w...w....l...w
w...w..v.h...w
w...w........w
wwwwwwwwwwwwww